0000000000000002000000
0000222223200002000000
0000000003200002400000
0000000002200002220000
0000000032200000000000
0000000032200000000000
0010000033300000000000
0000000033300000000000
0033333332200000000000