1000000200000200002000
0022200200020202002000
0020200200020202002000
0020200000020202002000
0020222200020002000000
0000022232222222200000
0000022332333332200000
0000000000000000000040
0000022222222222200000