0000000000000000000
0000000000000000000
0000000000000000000
0000000000004000000
0000000333333300000
0000000000000300000
0000000000000300000
0000000000000300000
0000000000000300000
0000000000000300000
0000000000000300000
0000000000000200000
1000000000000200000
0000000000000300000
0033333333333300000
0000000000000000000
0000000000000000000
0000000000000000000
0000000000000000000